N ./maps/minecraft/Chiseled_Bookshelf.xpm
S ./maps/minecraft/Bookshelf.xpm
WE ./maps/minecraft/Empty_Bookshelf.xpm
EA ./maps/minecraft/Planks.xpm

C 153,204,255
F 129,92,68


11111111111111111
10000N00000110001
1000000000000001
1110011000000001
1000000000000001
1000010000100001
1000000000110001
1000000000000001
1000011000000001
11111111111111111

111111
1000N1
100001
111111
