N ./maps/cave/Light_Wall.xpm
S ./maps/cave/Mossy_Wall.xpm
WE ./maps/cave/Vines.xpm
EA ./maps/cave/Plant_Wall.xpm

C 153,204,255
F 50, 50, 50


111111111111111111111111111111
10000N0000011000000110000000001
100000000110000000000000000001
111001100000000110000000000001
100000110000000000000000000001
100001000010000000110000000001
100000000011000000110000000001
100001100000000000000000000001
100001100000000000011000000001
111111111111111111111111111111

111111
1000N1
100001
111111
