NO ./path.xpm
SO ./path.xpm
WE ./path.xpm
EA ./path.xpm

11111111
10000001
10000001
10000001
11111111

F 1,2,3
C 1,2,3