NO ./a
SO ./b.xpm
WE ./c.xpm
EA ./d.xpm

F 1,2,3
C 1,2,3

11111111111111
100011100N0011
10001 10000001
10001110000011
10000000000001
11111111111111
