NO ./path.xpm
SO ./path.xpm
WE ./path.xpm
EA ./path.xpm

F 1,2,3
C 1,2,3

11111111111111
100011100N0011
10001 10000001
10001110000011
10000000000
1000000000000
11111111111111
